................................................
.ww.............................................
.w..............................................
................................................
........wwwwwwwwwwwwww....wwwwwwwwwwwwww........
........w.....w.e...qw....w..h...w.....w........
........w.....w......w....w.....ew.....w........
........w.....w......w....w......w.....w........
....wwwww.....w..................w.....wwwww....
....w.e.......w..................w.........w....
....w.........w..................w.........w....
....w.........w..................w.........w....
..............w......w....we.....w..............
..............w......w....w......w..............
..............w......w....w......w..............
..............we.....w....w......w..............
....w.......e.w.....ew....w.....ew.........w....
....wwww..wwwwwwwwwwww....wwwwwwwwwwww..wwww....
....wh..........ccw..a......cw.............w....
....w............cw..........w.............w....
....w...e.........w.h........w.............w....
....wwwwwwwwwwwwwww..........wwwwwwwwwwwwwww....
................................................
................................................
................................................
................................................
....wwwwwwwwwwwwwww..........wwwwwwwwwwwwwww....
....w.............w..........w.............w....
....w.............w..........w.............w....
....w.............w..........w.............w....
....wwww..wwwwwwwwwwww....wwwwwwwwwwww..wwww....
....w.........w......w....w......w.........w....
..............w......w....w......w..............
..............w......w....w......w..............
..............w......w....w......w..............
..............w......w....w......w..............
....w.........w..................w.........w....
....w.........w..................w.........w....
....w.........w..................w.........w....
....wwwww.....w..................w......wwww....
........w.....w......w....w......w......w.......
........w.....w......w....w......w......w.......
........w.....w......w....w......w.....w........
........wwwwwwwwwwwwww....wwwwwwwwwwwwww........
................................................
................................................
................................................
................................................
